NO zmoumen.png
WE yowazga.png

SO zmoumen.png
EA yowazga.png


F 120,20,60
C 125,20,250



1111111111111111
1000000000000001
1000010000001101
1110001000101101
1000000000110001
1000000011101001
1000000000000101
1000000000000101
1111000001111101
1000000000000001
1110000101010101
  1011001010101111111111111111111111
110000000000000000000000000000000001
10000011000001000001000001111000001
10000000W0000000100000000001 100001
100000000000000000000000001  10001
10000000000111110000000001 110001
100000000001   1000000001 100001
100000000001  1000000001   1001
10000000001   100110001     101
1000110001   1001  1001     1011
1001 1001     1101 101      10001
101   1001      111101       1001
 1     1001       1001       101
        1001      101 111    101
         1001     10110001111001 
          1001111110110100000001
           100000000000111111111
            111111111111